....................
...........e.s......
.........rbgoy......
.b.e................
.ryoGBR.............
..........s.........
.........OYR........
...............S....
....RBG...g...BGO...
.+......s.b.......e.
rrbbggooyyrbgoyrbgoy