....................
...........e........
.........rbgoy......
.b.e................
.ryoGBR.............
....................
.........OYR........
....................
....RBG...g...BGO...
+.........b.......e.
rrbbggooyyrbgoyrbgoy