....................
....................
....................
....................
....................
....................
.........OYR........
....................
.+..RBG.......BGO...
....................
rrbbggooyyrbgoyrbgoy